width 10
height 10
data
2 3 4 5 6 7 8 8 7 9
9 0 0 0 0 0 0 0 0 9
9 0 0 0 0 0 0 0 0 9
9 9 0 0 0 0 7 0 0 9
9 9 0 0 0 0 6 0 0 9
9 9 0 0 0 0 5 0 0 9
9 9 9 0 0 0 4 0 0 9
9 9 9 0 0 0 3 0 0 9
9 9 9 0 0 0 2 0 0 9
9 9 9 9 9 9 9 9 0 9